Namespace,Type,Method,LOC,CC,PC
org.drools.tutorials.banking,__Account,__Account,2,1,1
org.drools.tutorials.banking,__Account,InitJNI,3,1,2
org.drools.tutorials.banking,__Account,__Init,11,1,2
org.drools.tutorials.banking,__Account,AccountNo0,11,1,2
org.drools.tutorials.banking,__Account,AccountNo1,9,1,3
org.drools.tutorials.banking,__Account,Balance2,11,1,2
org.drools.tutorials.banking,__Account,Balance3,9,1,3
org.drools.tutorials.banking,__Account,__ctorAccount0,9,1,3
org.drools.tutorials.banking,__Account,__ctorAccount1,9,1,4
org.drools.tutorials.banking,ContructionHelper,CreateProxy,3,1,1
org.drools.tutorials.banking,ContructionHelper,CreateProxy,3,1,1
org.drools.tutorials.banking,ContructionHelper,CreateProxy,3,1,1
org.drools.tutorials.banking,ContructionHelper,CreateProxy,3,1,1
org.drools.tutorials.banking,__AllocatedCashflow,__AllocatedCashflow,2,1,1
org.drools.tutorials.banking,__AllocatedCashflow,InitJNI,3,1,2
org.drools.tutorials.banking,__AllocatedCashflow,__Init,12,1,2
org.drools.tutorials.banking,__AllocatedCashflow,Account0,11,1,2
org.drools.tutorials.banking,__AllocatedCashflow,Account1,9,1,3
org.drools.tutorials.banking,__AllocatedCashflow,__ctorAllocatedCashflow0,9,1,3
org.drools.tutorials.banking,__AllocatedCashflow,__ctorAllocatedCashflow1,9,1,7
org.drools.tutorials.banking,__AllocatedCashflow,__ctorAllocatedCashflow2,9,1,7
org.drools.tutorials.banking,__Cashflow,__Cashflow,2,1,1
org.drools.tutorials.banking,__Cashflow,InitJNI,3,1,2
org.drools.tutorials.banking,__Cashflow,__Init,12,1,2
org.drools.tutorials.banking,__Cashflow,Date0,11,1,2
org.drools.tutorials.banking,__Cashflow,Date1,9,1,3
org.drools.tutorials.banking,__Cashflow,Amount2,11,1,2
org.drools.tutorials.banking,__Cashflow,Amount3,9,1,3
org.drools.tutorials.banking,__Cashflow,__ctorCashflow0,9,1,3
org.drools.tutorials.banking,__Cashflow,__ctorCashflow1,9,1,5
org.drools.tutorials.banking,__Cashflow,__ctorCashflow2,9,1,5
org.drools.tutorials.banking,__TypedCashflow,__TypedCashflow,2,1,1
org.drools.tutorials.banking,__TypedCashflow,InitJNI,3,1,2
org.drools.tutorials.banking,__TypedCashflow,__Init,10,1,2
org.drools.tutorials.banking,__TypedCashflow,Type0,11,1,2
org.drools.tutorials.banking,__TypedCashflow,Type1,9,1,3
org.drools.tutorials.banking,__TypedCashflow,__ctorTypedCashflow0,9,1,3
org.drools.tutorials.banking,__TypedCashflow,__ctorTypedCashflow1,9,1,6
org.drools.tutorials.banking,__TypedCashflow,__ctorTypedCashflow2,9,1,6
